51 51
000000000000000000000000000000000000000000000000000
0###########0#######0#########000000000000000000000
0#.........#0#.....#0#......s#000000000000000000000
0#.........#=#.....#=#..###..#000000000000000000000
0#....@.....D...c...D.......g#000000000000000000000
0#.........#=#.....#=#...g...#000000000000000000000
0#.........#0#.....#0#s......#000000000000000000000
0#####.#####0#######0#########000000000000000000000
00000=D=0000000000000000000000000000000000000000000
0#####.#####000000000000000000000000000000000000000
0#.........#0#######0000000000000000000000000000000
0#.........#0#.....#0000000000000000000000000000000
0#.........#0#.....#0000000000000000000000000000000
0#.........#=#.....#0000000000000000000000000000000
0#g...#...g.D...T..#0000000000000000000000000000000
0#.........#=#.....#0000000000000000000000000000000
0#.........#0#.....#0000000000000000000000000000000
0#.........#0#.....#0000000000000000000000000000000
0#s.......s#0###.###0000000000000000000000000000000
0###########000=D=000000000000000000000000000000000
0000000000000###.###0000000000000000000000000000000
0###########0#.....#0000000000000000000000000000000
0#g...s...g#0##...##0000000000000000000000000000000
0#.........#0#.....#0000000000000000000000000000000
0#.g.....g.#0#.....#0000000000000000000000000000000
0#....g....#0#s.#.s#0000000000000000000000000000000
0#.........#0#.....#0000000000000000000000000000000
0#.........#0#sssss#0000000000000000000000000000000
0#####.#####0###.###0000000000000000000000000000000
00000=D=0000000=D=000000000000000000000000000000000
0000##.#########.##00000000000000000000000000000000
0000#s............#00000000000000000000000000000000
0000#s............#00000000000000000000000000000000
0000#######.#######00000000000000000000000000000000
0000000000=D=00000000000000000000000000000000000000
000000#####.#####0000000000000000000000000000000000
000000#s..#.#..s#0000000000000000000000000000000000
000000#..#...#..#0000000000000000000000000000000000
000000#s.......s#0000000000000000000000000000000000
000000#####.#####0000000000000000000000000000000000
0000000000=D=00000000000000000000000000000000000000
00000######.######000000000000000000000000000000000
00000#ssss#.#ssss#000000000000000000000000000000000
00000#....#.#....#000000000000000000000000000000000
00000#...........#000000000000000000000000000000000
00000#...........#000000000000000000000000000000000
00000#...........#000000000000000000000000000000000
00000#...........#000000000000000000000000000000000
00000#...........#000000000000000000000000000000000
00000#############000000000000000000000000000000000
000000000000000000000000000000000000000000000000000