21 21
000000000000000000000
0###########0#######0
0#.........#0#.....#0
0#.........#=#.....#0
0#....@.....D...c..#0
0#.........#=#.....#0
0#.........#0#.....#0
0#####.#####0#######0
00000=D=0000000000000
0#####.#####000000000
0#.........#0#######0
0#.........#0#.....#0
0#.........#0#.....#0
0#.........#=#.....#0
0#e...#...e.D...T..#0
0#.........#=#.....#0
0#.........#0#.....#0
0#.........#0#.....#0
0#.........#0#######0
0###########000000000
000000000000000000000