51 51
000000000000000000000000000000000000000000000000000
0###########0#######0#########000000000000000000000
0#.........#0#.....#0#......s#000000000000000000000
0#.........#=#.....#=#..###..#000000000000000000000
0#....@.....D...c...D.......g#000000000000000000000
0#.........#=#.....#=#...g...#000000000000000000000
0#.........#0#.....#0#s......#000000000000000000000
0#####.#####0#######0#########000000000000000000000
00000=D=0000000000000000000000000000000000000000000
0#####.#####000000000000000000000000000000000000000
0#.........#0#######0000000000#######00000000000000
0#.........#0#.....#0########0##sss##00000000000000
0#.........#0#.....#0#g#g#g##0##...##00000000000000
0#....B....#=#.....#=########=##...##=###0000000000
0#g...#...g.D...T...D........D.....g.D.c#0000000000
0#.........#=#.....#=########=##...##=###0000000000
0#.........#0#.....#0##g#g#g#0##...##00000000000000
0#.........#0#.....#0########0##sss##00000000000000
0#s.......s#0###.###0000000000#######00000000000000
0###########000=D=000000000000000000000000000000000
0000000000000###.###0000000000000000000000000000000
0###########0#.....#0000000000000000000000000000000
0#g...s...g#0##...##0000000000000000000000000000000
0#.........#0#.....#0000000000000000000000000000000
0#.g.....g.#0#.....#0000000000000000000000000000000
0#....g....#0#s.#.s#0000000000000000000000000000000
0#.........#0#.....#0000000000000000000000000000000
0#.........#0#sssss#0000000000000000000000000000000
0#####.#####0###.###0000000000000000000000000000000
00000=D=0000000=D=000000000000000000000000000000000
0000##.#########.##00000000000000000000000000000000
0000#s............#00000000000000000000000000000000
0000#s............#00000000000000000000000000000000
0000#######.#######00000000000000000000000000000000
0000000000=D=00000000000000000000000000000000000000
000000#####.#####0000000000000000000000000000000000
000000#s..#.#..s#0000000000000000000000000000000000
000000#..#...#..#000000000000##############00000000
000000#s.......s#000000000000#............#00000000
000000#####.#####000000000000#............#00000000
0000000000=D=0000000000000000#............#00000000
00000######.######00000000000#............#00000000
00000#ssss#.#ssss#0#########=#............#00000000
00000#....#.#....#0##.g.s#s.D..........B..#00000000
00000#...........#=##.##.#g#=#............#00000000
00000#............D...##s..#0#............#00000000
00000#...........#=#########0#............#00000000
00000#...........#00000000000#............#00000000
00000#############00000000000#............#00000000
00000000000000000000000000000##############00000000
000000000000000000000000000000000000000000000000000
16 4 starter
39 14 starter