21 21
000000000000000000000
0###########0#######0
0#.........#0#.....#0
0#.........#=#.....#0
0#....@.....d......#0
0#.........#=#.....#0
0#.........#0#.....#0
0#####.#####0#######0
00000=d=0000000000000
0#####.#####000000000
0#.........#0#######0
0#.........#0#.....#0
0#.........#0#.....#0
0#.........#=#.....#0
0#e...#...e.d...T..#0
0#.........#=#.....#0
0#.........#0#.....#0
0#.........#0#.....#0
0#.........#0#######0
0###########000000000
000000000000000000000