21 13
000000000000000000000
0###########000000000
0#.........#0#######0
0#-........#0#.....#0
0#.........#0#.....#0
0#.........###.....#0
0#-...@....d....T..#0
0#.........###.....#0
0#.........#0#.....#0
0#.........#0#.....#0
0#.........#0#######0
0###########000000000
000000000000000000000