13 13
0000000000000
0###########0
0#......T..#0
0#-........#0
0#.........#0
0#.........#0
0#-...@....#0
0#.........#0
0#.........#0
0#.........#0
0#.........#0
0###########0
0000000000000