51 32
000000000000000000000000000000000000000000000000000
0####0000000000000000000000000000000000000000000000
0#@.#0000000000000000000000000000000000000000000000
0#.##0000000000000000000000000000000000000000000000
0=D=00000000000000000000000000000000000000000000000
0#.###########0000000000000000000000000000000000000
0#B.........s#0000000000000000000000000000000000000
0###.#####.###0000000000000000000000000000000000000
0###.......###0000000000000000000000000000000000000
0######.######0000000000000000000000000000000000000
0#gg###.###gg#0000000000000000000000000000000000000
0######.######000000###0000000000000000000000000000
000000=D=00000000000#c#0000000000000000000000000000
0####0#.#00000000000#.#0000000000000000000000000000
0#ss#0#.#00000000000=D=0000000000000000000000000000
0#..#=#.#=#######=###.####0000000000000000000000000
0#...D...D...s#T.D.......#0000000000000000000000000
0#..#=#.#=#######=######.#0000000000000000000000000
0#..#0#.#00000000000000=D=0000000000000000000000000
0#..#0=D=00000000000000#.#0000000000000000000000000
0#g.#0#.#=############0#.#0000000000000000000000000
0#sc#0#..D...........#0#.#0000000000000000000000000
0####0#g#=#.########.#0#.#0000000000000000000000000
000000###0#.#........#=#.#=##########=##########=00
0000000000#.#.........D...D..........D........g.D00
0000000000#.#........#=###=#..#..#..#=.........#=00
0000000000############00000#........#0#g###g####000
0000000000############00000#........#0###g##g###000
0000000000############00000#ss.ss.ss#0#g######g#000
0000000000#######gggg#00000##########0##########000
0000000000############00000000000000000000000000000
000000000000000000000000000000000000000000000000000
3 21 starter
21 12 starter