11 11
...###00000
..##.#.####
.##..###..#
##......T.#
#...@..#..#
###..###..#
..#..#....#
.##.##.#.##
.#......##0
.#.....##00
.#######000